########
# S    #
# ###  #
#   ## #
#    # #
#   E# #
#   ## #
#      #
########
